+-----+----------------+
|color|total_paint_used|
+-----+----------------+
|G    |3051            |
|B    |3074            |
|R    |3145            |
+-----+----------------+
