+---------+----------+
|square_id|num_sprays|
+---------+----------+
|1        |3         |
|2        |3         |
|3        |3         |
|5        |6         |
|6        |4         |
|7        |4         |
|9        |4         |
|10       |6         |
|11       |6         |
|12       |6         |
+---------+----------+
